NO textures/no_matrix.xpm
SO textures/so_matrix.xpm
WE textures/we_matrix.xpm
EA textures/ea_matrix.xpm

F 220,100,0
C 50,50,80

    1111111
    1000001
111110000011111
100000N000000001
111111000011111
    1000001
    1111111
