NO textures/no_matrix.xpm
SO textures/so_matrix.xpm
WE textures/we_matrix.xpm
EA textures/ea_matrix.xpm

F 220,100,0
C 50,50,80

1 1111111
11100001
10000001
100N0001
11111111
