NO textures/no_matrix.xpm
SO textures/so_matrix.xpm
WE textures/we_matrix.xpm
EA textures/ea_matrix.xpm

F 20,100,43
C 50,       50,204




11111111
10000001
1000011
100S011
11111111

