NO textures/no_matrix.xpm
SO textures/so_matrix.xpm
WE textures/we_matrix.xpm
EA textures/ea_matrix.xpm

F 220,100,0
C 50,50,80

11111111
10000011
1000000
100N0001
11111111
