      NO         textures/no_matrix.xpm




             SO          textures/so_matrix.xpm
WE          textures/we_matrix.xpm




   EA textures/ea_matrix.xpm

    F                    220,100,0  







                C                     50,           50,80







0011111110000
   1111011001
    111111111111100
   11111001N0000010000
000100 00011111111
 001001010001
   1111011111
   111
