      NO         textures/no_matrix.xpm




             SO          textures/so_matrix.xpm
WE          textures/we_matrix.xpm

F                    220,100,0  



   EA textures/ea_matrix.xpm








                C                     50,           50,80






111111111
100000001
10000N001
111111011
