      NO         textures/no_matrix.xpm




             SO          textures/so_matrix.xpm
WE          textures/we_matrix.xpm




   EA textures/ea_matrix.xpm

    F                    220,100,0  







                C                     50,           50,80







  111
1111011001
1111011110
1001N000010000000
1000000001
10010100010
1111011111
   111
