NO textures/no_matrix.xpm
SO textures/so_matrix.xpm
WE textures/we_matrix.xpm
EA textures/ea_matrix.xpm

F 112,120,200
C  200,100,160

111111111111111111111111
100000000000000100000001
101000000000000000000001
10100000000N000000000001
101000000000000100000001
101000001111111111011111
101000010101010101100011
101000010000000011000001
101000000000000000001111
101000010000000011000001
100000001000000011000111
100000011110011111111111
111111111011111111111111
100000000000000000000001
111111011110111111111111
111111011110111111111111
100000000110110000010001
100000000000110010010001
100000000110110000110110
101010000110000100000001
100100000110110000110111
101010000110110001001001
100000000110110000010001
111111111111111111111111